NO textures/north.xpm
SO textures/south.xpm
WE textures/west.xpm
EA textures/east.xpm

F 220,100,0
C 225,30,0



        1111111111111111111111111
        10000000001100000011111111
        10110000011101111001111111
        1001010000111   1110000001
11111111101100000111011110011111111
10000000001100000111011111111111111
1111011111111101110000001000111
11110111111111011101010010001
1110100011011101110000001000111111
1111 10000000000000001100000010011
1111101000000000001101010010001111
1100000111010101111101111010111
1111N111 1110101 10111101000111
11111111111111111111111111111
11111111111111111111111111111
11111111111111111111111111111
                1          
                1           
                1             
11111111111111111111111111111
