NO textures/north.xpm
SO textures/south.xpm
WE textures/west.xpm
EA textures/east.xpm

F 220,100,0
C 225,30,0
        1111111111111111111111111
        1000000000110000000000001
        1011000001110000000000001
        1001000000000000000000001
111111111011000001110000000000001
100000000011000001110111110111111
11110111111111011100000010001
11110111111111011101010010001
11000000110101011100000010001
10000000000000001100000010001
10000000000000001101010010001
1100000111010101111101111000111
11110111 1010101 101111010001
11111111 10111111 111111111111111111
10000011 101000011000000000000000001
10000001 10000001001000000001000W001
10000001 1000000101100000000100000001
10000001110000001011111111111111111111
10000000100000011000000000000000000001
10000000000000001111111111111111111101
10000000000000000000000000000000000001
11111111111111111111111111111111111111
