NO textures/north.xpm
SO textures/south.xpm
WE textures/west.xpm
EA textures/east.xpm

F 220,100,0
C 225,30,0

        1111111111111111111111111
        1000000000110000000000001
        1011000001110000000000001
        1001000000000000000000001
111111111011000001110000000000001
100000000011000001110111111111111
11110111111111011100000010001
11110111111111011101010010001
11000000110111011100000010001
1 1000000000000000110000001001
11000000000000001101010010001
11000001110101011111011110N0111
11110111 1110101 101111010001
1 111111 1111111 111111111111