

SO               textures/south.xpm



EA        textures/east.xpm
WE textures/west.xpm
NO textures/north.xpm
C               96,96,96


F                                     0,126,96

11111
100S1
10001
11111