NO textures/north.xpm
SO textures/south.xpm
WE textures/west.xpm
EA textures/east.xpm

F 151,155,166
C 141,229,249

1111111111111
100000P000001
1000000000001
1000011100001
10001   10001
1000011100001
1000000000001
1000000000001
1111111111111