NO textures/north.xpm
SO textures/south.xpm
WE textures/west.xpm
EA textures/east.xpm
F 110,153,15
C 255,255,255

        1111111111111111111111111
        1000000000000000000000001
        1200000000000000000000001
        1000000000000000000000001
111111111000000000000000000000001
10000000000000N000000000000001111
10000000000000000000000000001
10000000000000000000000000001
10000000000000000000000000001
10000000000000000000000000001
10000000000000000001010000001
11000001110101010111011110101
11110111 1110121 101111010001
11111111 1111111 111111111111
