NO textures/north.xpm
WE textures/west.xpm
EA                 textures/east.xpm
SO textures/south.xpm

F 151,155,300
C 141,229,249

1111111111111
100000N000001
1000000000001
1000011100001
10001   10001
1000011100001
1000000000001
1000000000001
1111111111111
