NO textures/north.xpm
SO textures/south.xpm
WE textures/west.xpm
EA textures/east.xpm
F 110,153,15
C 255,255,25

        1111111111111111011111111
        1000000000000000000000001
        1100000000000000000000001
        1000000000000000000000001
111111111000000000000000000000001
100000000000000000000000000001111
10000000000000E111111100000001
1000000000000001     100000001
1000000000000001 111 100000001
1000000000000001 1011100000001
1000000000000001 1000000000001
1100000111010101 1111011110101
11110111 1110111 101111010001
11111111 1111111 111111111111
