NO textures/north.xpm
SO textures/south.xpm
EA textures/east.xpm
WE textures/west.xpm

F 151,155,155
C 141,119,149

1111111111111
1000000000001
1000000000001
1000011100001
10001   1000W
1000011100001
1000000000001
1000000000001
1111111111111
