
 SO               textures/south.xpm



EA        textures/east.xpm
C               141,229,249


NO         textures/north.xpm
F    151,155,166
WE textures/west.xpm


        111111111111111111111111111111
        100000000011001S100000001
        1011000001110010100000001
        100100000000000000000001
111111111011000001110000000000001
100000000011000001110000000011111
11110111111111011100000000001
1111000000000001110100000001
1100001111111101110000000001
1000001     10000000000000011111
1000001      1111000000000000001
1000101       100000000010111111
110000011111111111110000100001
11110111 1110101 101000000001
11111111 1111111 11100001111
1111111111111111111100000111
111111111111100000000000111
        1111111111110010111111111
        1000000000110000000000001
        1011000001110000000000001
        1001000000000000000000001
111111111011000001110000000000001
100000000011000001110000001111111
11110111111111011100000010001
11110000000000011101010010001
11000011111111011100000010001
1000001     100000001100000111111
1000001      11110000011000000001
1000101       1000000011010111111
11000001111111111111011110001
11110111 1110101 101111010001
11111111 1111111 111111111111
