NO textures/north.xpm
SO textures/south.xpm

F                 151,155,166
WE textures/west.xpm

C          141,119,149

EA textures/east.xpm

             111111111111
          11111S00111111111
        11111110001   111111
        10000000111   10011111
        101100000111111110011111
         10101000011100011001
1111111111110110000011101111
111100000000010000011101111
    11110000000000111111                   1111111
    1011000100000000011                  11100000111
    111100011110011011                   11100000111
 11111 1101111 101111111                   1110111
        101    101                           101
        101    101                           101   
        1011   10111                         101  
11111111101111110111111111111111111111111111110111111111
10000000000000000000000000000000000000000000000000000001
11111111111111111111111111111111111111111111111111111111
