
NO textures/north.xpm
SO textures/south.xpm
EA textures/east.xpm
WE textures/west.xpm

C 96,96,96
F 96,96,96

11111
100W1
10001
11111