NO textures/north.xpm
SO textures/south.xpm
WE textures/west.xpm
EA textures/east.xpm

F 220,100,0
C 225,30,0


             111111111111
          11111000111111111
        11111110001   111111
        10000000111   10011111
        101100000111111110011111
        100101000011100011001
1111111111110110000011101111
111100000000000000011101111
    11110000000000111111                    11111
    111100010N010000011                   110000011
    111100011110011011                    110000011
 11111 1111111 111111111                    11111
        11     11                             1
        11     11                             1
        1111   1111                           1
11111111111111111111111111111111111111111111111111111111