

SO               textures/south.xpm



EA        textures/east.xpm
C               96,96,96


NO         textures/north.xpm
F   96,96,96
WE textures/west.xpm
        1111111111111111111111111  
                1
        1000000000110000000000001
        1011000001110000000000001
        10010000000000000000W0001
111111111011000001110000000000001
100000000011000001110000001111111
11110111111111011100000010001
11110000000000011101010010001
11000011111111011100000010001
1000001     100000001100000111111
1000001      11110000011000000001
1000101       1000000011010111111
11000001111111111111011100001
11110111 1110101 101111000001
11111111 1111111 11111101111
1111111111111111111111111  
1
1111111111111111111111111
        1111111111111110111111111
        1000000000110000000000001
        1011000001110000000000001
        1001000000000000000000001
111111111011000001110000000000001
100000000011000001110000001111111
11110111111111011100000010001
11110000000000011101010010001
11000011111111011100000010001
1000001     100000001100000111111
1000001      11110000011000000001
1000101       1000000011010111111
11000001111111111111011110001
11110111 1110101 101111010001
11111111 1111111 111111111111