NO textures/north.xpm
SO textures/south.xpm
WE textures/west.xpm
EA textures/east.xpm

F 220,100,0
C 225,30,0

   1111111111111111111111111
11110000000110000000000001
101100000111011110000001111
1001000000001   10000000001
1111111110111   100111000011
  1000000000111111000111011111
11110111111111011100000011
11110111111111011101010011
  111000001101010111000000111
1100000011110N00001100000011
1111000001  1000001101010011
110000011111010111110111111
11110111111110110111101001
11111111111111111111111111111
1
1
1
111
1
1
1111
11
1
1