NO textures/north.xpm
SO textures/south.xpm
WE textures/west.xpm
EA textures/east.xpm

F 220,100,0
C 225,30,0

1111111111111111111111111
1000000000110000000000001
1011000001110100000000001
1001000000001 10000000001
1111111110111 100111000011
10000000001101000111011111
11110111111111011100000011
11110111111111011101010011
11000000110101011100000011
10000000110N00001100000011
10000001  1000001101010011
11000001110101011111011111
11110111111010110111101001
111111111111111111111111111